NO Makefile

WE Makefile

SO Makefile




EA Makefile

F 255,255,255

C 204,204,255





 

111111111111
100000000001
11001100N001
100001111111
111111111111