NO Makefile

SO Makefile

WE Makefile

EA Makefile



F 220,100,4
C 225,30,84






 

        1111111111111111111111111

        111111111111111111111111 
        1000000000110000000000001
        1011000001110000000000001
        10010000000000000000000001
11111111101100000111000000000001
100000000011N0000111011111111111 
111101111111110111000000100001
111101011111110111010010010001     111111
11000000110101011100000010001      111011
10000000000000001100000010001      111011
10000000000000001101010010001      111111
11000011101010111110111000111
11110111 1110101 101111010001
    1       1 1   1    1 111
11111111 1111111 111111111111
